关键词,日期,省份,城市,PC+移动端,PC端,移动端
结婚,20220101,广东,广东,507,70,437
结婚,20220102,广东,广东,387,82,305
结婚,20220103,广东,广东,409,83,326
结婚,20220104,广东,广东,406,82,324
结婚,20220105,广东,广东,430,72,358
结婚,20220106,广东,广东,467,93,374
结婚,20220107,广东,广东,557,72,485
结婚,20220108,广东,广东,444,85,359
结婚,20220109,广东,广东,439,78,361
结婚,20220110,广东,广东,452,104,348
结婚,20220111,广东,广东,430,102,328
结婚,20220112,广东,广东,486,99,387
结婚,20220113,广东,广东,547,87,460
结婚,20220114,广东,广东,512,80,432
结婚,20220115,广东,广东,455,93,362
结婚,20220116,广东,广东,481,97,384
结婚,20220117,广东,广东,454,99,355
结婚,20220118,广东,广东,464,87,377
结婚,20220119,广东,广东,499,87,412
结婚,20220120,广东,广东,473,78,395
结婚,20220121,广东,广东,395,72,323
结婚,20220122,广东,广东,470,70,400
结婚,20220123,广东,广东,461,95,366
结婚,20220124,广东,广东,403,87,316
结婚,20220125,广东,广东,401,74,327
结婚,20220126,广东,广东,422,82,340
结婚,20220127,广东,广东,403,93,310
结婚,20220128,广东,广东,402,76,326
结婚,20220129,广东,广东,410,72,338
结婚,20220130,广东,广东,406,76,330
结婚,20220131,广东,广东,431,82,349
结婚,20220201,广东,广东,463,83,380
结婚,20220202,广东,广东,404,70,334
结婚,20220203,广东,广东,477,82,395
结婚,20220204,广东,广东,379,72,307
结婚,20220205,广东,广东,349,61,288
结婚,20220206,广东,广东,341,70,271
结婚,20220207,广东,广东,376,63,313
结婚,20220208,广东,广东,379,66,313
结婚,20220209,广东,广东,360,57,303
结婚,20220210,广东,广东,367,57,310
结婚,20220211,广东,广东,405,64,341
结婚,20220212,广东,广东,465,85,380
结婚,20220213,广东,广东,478,87,391
结婚,20220214,广东,广东,479,95,384
结婚,20220215,广东,广东,500,101,399
结婚,20220216,广东,广东,646,125,521
结婚,20220217,广东,广东,557,106,451
结婚,20220218,广东,广东,525,93,432
结婚,20220219,广东,广东,503,74,429
结婚,20220220,广东,广东,538,101,437
结婚,20220221,广东,广东,406,76,330
结婚,20220222,广东,广东,454,101,353
结婚,20220223,广东,广东,489,99,390
结婚,20220224,广东,广东,462,99,363
结婚,20220225,广东,广东,479,82,397
结婚,20220226,广东,广东,450,83,367
结婚,20220227,广东,广东,416,93,323
结婚,20220228,广东,广东,593,129,464
结婚,20220301,广东,广东,411,101,310
结婚,20220302,广东,广东,444,106,338
结婚,20220303,广东,广东,358,91,267
结婚,20220304,广东,广东,424,76,348
结婚,20220305,广东,广东,396,70,326
结婚,20220306,广东,广东,431,104,327
结婚,20220307,广东,广东,418,110,308
结婚,20220308,广东,广东,408,91,317
结婚,20220309,广东,广东,358,76,282
结婚,20220310,广东,广东,397,83,314
结婚,20220311,广东,广东,463,102,361
结婚,20220312,广东,广东,479,91,388
结婚,20220313,广东,广东,471,102,369
结婚,20220314,广东,广东,471,120,351
结婚,20220315,广东,广东,402,89,313
结婚,20220316,广东,广东,498,104,394
结婚,20220317,广东,广东,380,91,289
结婚,20220318,广东,广东,443,85,358
结婚,20220319,广东,广东,460,83,377
结婚,20220320,广东,广东,438,108,330
结婚,20220321,广东,广东,382,87,295
结婚,20220322,广东,广东,413,101,312
结婚,20220323,广东,广东,373,74,299
结婚,20220324,广东,广东,412,102,310
结婚,20220325,广东,广东,453,95,358
结婚,20220326,广东,广东,528,116,412
结婚,20220327,广东,广东,475,106,369
结婚,20220328,广东,广东,405,85,320
结婚,20220329,广东,广东,467,118,349
结婚,20220330,广东,广东,371,93,278
结婚,20220331,广东,广东,390,106,284
结婚,20220401,广东,广东,407,83,324
结婚,20220402,广东,广东,463,91,372
结婚,20220403,广东,广东,438,97,341
结婚,20220404,广东,广东,435,95,340
结婚,20220405,广东,广东,407,101,306
结婚,20220406,广东,广东,716,118,598
结婚,20220407,广东,广东,557,106,451
结婚,20220408,广东,广东,356,78,278
结婚,20220409,广东,广东,381,85,296
结婚,20220410,广东,广东,394,85,309
结婚,20220411,广东,广东,435,91,344
结婚,20220412,广东,广东,360,87,273
结婚,20220413,广东,广东,381,82,299
结婚,20220414,广东,广东,361,83,278
结婚,20220415,广东,广东,394,68,326
结婚,20220416,广东,广东,389,66,323
结婚,20220417,广东,广东,400,102,298
结婚,20220418,广东,广东,439,108,331
结婚,20220419,广东,广东,401,80,321
结婚,20220420,广东,广东,445,76,369
结婚,20220421,广东,广东,369,80,289
结婚,20220422,广东,广东,403,83,320
结婚,20220423,广东,广东,398,68,330
结婚,20220424,广东,广东,425,101,324
结婚,20220425,广东,广东,405,89,316
结婚,20220426,广东,广东,404,80,324
结婚,20220427,广东,广东,429,87,342
结婚,20220428,广东,广东,413,93,320
结婚,20220429,广东,广东,401,70,331
结婚,20220430,广东,广东,411,87,324
结婚,20220501,广东,广东,396,97,299
结婚,20220502,广东,广东,401,74,327
结婚,20220503,广东,广东,374,82,292
结婚,20220504,广东,广东,400,80,320
结婚,20220505,广东,广东,380,72,308
结婚,20220506,广东,广东,428,76,352
结婚,20220507,广东,广东,522,70,452
结婚,20220508,广东,广东,486,74,412
结婚,20220509,广东,广东,383,70,313
结婚,20220510,广东,广东,484,93,391
结婚,20220511,广东,广东,441,95,346
结婚,20220512,广东,广东,400,87,313
结婚,20220513,广东,广东,443,97,346
结婚,20220514,广东,广东,554,95,459
结婚,20220515,广东,广东,444,93,351
结婚,20220516,广东,广东,448,87,361
结婚,20220517,广东,广东,494,93,401
结婚,20220518,广东,广东,505,104,401
结婚,20220519,广东,广东,453,95,358
结婚,20220520,广东,广东,440,70,370
结婚,20220521,广东,广东,454,80,374
结婚,20220522,广东,广东,443,87,356
结婚,20220523,广东,广东,422,89,333
结婚,20220524,广东,广东,426,102,324
结婚,20220525,广东,广东,399,78,321
结婚,20220526,广东,广东,561,104,457
结婚,20220527,广东,广东,484,82,402
结婚,20220528,广东,广东,467,70,397
结婚,20220529,广东,广东,434,89,345
结婚,20220530,广东,广东,418,80,338
结婚,20220531,广东,广东,405,78,327
结婚,20220601,广东,广东,417,87,330
结婚,20220602,广东,广东,421,72,349
结婚,20220603,广东,广东,412,66,346
结婚,20220604,广东,广东,422,78,344
结婚,20220605,广东,广东,410,83,327
结婚,20220606,广东,广东,379,80,299
结婚,20220607,广东,广东,369,80,289
结婚,20220608,广东,广东,402,82,320
结婚,20220609,广东,广东,427,66,361
结婚,20220610,广东,广东,463,76,387
结婚,20220611,广东,广东,411,76,335
结婚,20220612,广东,广东,436,99,337
结婚,20220613,广东,广东,385,78,307
结婚,20220614,广东,广东,467,97,370
结婚,20220615,广东,广东,430,93,337
结婚,20220616,广东,广东,384,95,289
结婚,20220617,广东,广东,407,74,333
结婚,20220618,广东,广东,448,74,374
结婚,20220619,广东,广东,347,70,277
结婚,20220620,广东,广东,413,89,324
结婚,20220621,广东,广东,387,91,296
结婚,20220622,广东,广东,381,89,292
结婚,20220623,广东,广东,381,87,294
结婚,20220624,广东,广东,396,66,330
结婚,20220625,广东,广东,411,78,333
结婚,20220626,广东,广东,375,87,288
结婚,20220627,广东,广东,334,89,245
结婚,20220628,广东,广东,355,87,268
结婚,20220629,广东,广东,366,93,273
结婚,20220630,广东,广东,355,70,285
结婚,20220701,广东,广东,388,74,314
结婚,20220702,广东,广东,413,83,330
结婚,20220703,广东,广东,361,91,270
结婚,20220704,广东,广东,387,85,302
结婚,20220705,广东,广东,389,83,306
结婚,20220706,广东,广东,366,89,277
结婚,20220707,广东,广东,342,76,266
结婚,20220708,广东,广东,423,76,347
结婚,20220709,广东,广东,394,80,314
结婚,20220710,广东,广东,402,85,317
结婚,20220711,广东,广东,414,95,319
结婚,20220712,广东,广东,377,85,292
结婚,20220713,广东,广东,362,85,277
结婚,20220714,广东,广东,389,91,298
结婚,20220715,广东,广东,367,82,285
结婚,20220716,广东,广东,392,72,320
结婚,20220717,广东,广东,378,82,296
结婚,20220718,广东,广东,412,82,330
结婚,20220719,广东,广东,407,91,316
结婚,20220720,广东,广东,372,78,294
结婚,20220721,广东,广东,383,82,301
结婚,20220722,广东,广东,336,61,275
结婚,20220723,广东,广东,415,91,324
结婚,20220724,广东,广东,401,78,323
结婚,20220725,广东,广东,390,85,305
结婚,20220726,广东,广东,413,76,337
结婚,20220727,广东,广东,371,89,282
结婚,20220728,广东,广东,354,74,280
结婚,20220729,广东,广东,365,76,289
结婚,20220730,广东,广东,408,78,330
结婚,20220731,广东,广东,347,83,264
结婚,20220801,广东,广东,348,78,270
结婚,20220802,广东,广东,348,93,255
结婚,20220803,广东,广东,370,78,292
结婚,20220804,广东,广东,345,74,271
结婚,20220805,广东,广东,326,64,262
结婚,20220806,广东,广东,381,83,298
结婚,20220807,广东,广东,357,80,277
结婚,20220808,广东,广东,389,74,315
结婚,20220809,广东,广东,362,102,260
结婚,20220810,广东,广东,486,93,393
结婚,20220811,广东,广东,425,95,330
结婚,20220812,广东,广东,371,64,307
结婚,20220813,广东,广东,413,72,341
结婚,20220814,广东,广东,408,74,334
结婚,20220815,广东,广东,352,91,261
结婚,20220816,广东,广东,356,87,269
结婚,20220817,广东,广东,364,93,271
结婚,20220818,广东,广东,370,82,288
结婚,20220819,广东,广东,336,74,262
结婚,20220820,广东,广东,349,87,262
结婚,20220821,广东,广东,339,101,238
结婚,20220822,广东,广东,348,80,268
结婚,20220823,广东,广东,320,89,231
结婚,20220824,广东,广东,383,87,296
结婚,20220825,广东,广东,323,89,234
结婚,20220826,广东,广东,383,70,313
结婚,20220827,广东,广东,329,72,257
结婚,20220828,广东,广东,371,101,270
结婚,20220829,广东,广东,348,91,257
结婚,20220830,广东,广东,373,93,280
结婚,20220831,广东,广东,365,95,270
结婚,20220901,广东,广东,384,93,291
结婚,20220902,广东,广东,350,82,268
结婚,20220903,广东,广东,437,70,367
结婚,20220904,广东,广东,381,80,301
结婚,20220905,广东,广东,389,95,294
结婚,20220906,广东,广东,470,101,369
结婚,20220907,广东,广东,446,106,340
结婚,20220908,广东,广东,374,97,277
结婚,20220909,广东,广东,428,83,345
结婚,20220910,广东,广东,388,80,308
结婚,20220911,广东,广东,425,102,323
结婚,20220912,广东,广东,411,97,314
结婚,20220913,广东,广东,374,87,287
结婚,20220914,广东,广东,418,95,323
结婚,20220915,广东,广东,495,104,391
结婚,20220916,广东,广东,434,74,360
结婚,20220917,广东,广东,473,76,397
结婚,20220918,广东,广东,517,95,422
结婚,20220919,广东,广东,430,116,314
结婚,20220920,广东,广东,394,78,316
结婚,20220921,广东,广东,437,106,331
结婚,20220922,广东,广东,410,93,317
结婚,20220923,广东,广东,511,72,439
结婚,20220924,广东,广东,597,76,521
结婚,20220925,广东,广东,398,106,292
结婚,20220926,广东,广东,408,85,323
结婚,20220927,广东,广东,506,87,419
结婚,20220928,广东,广东,453,93,360
结婚,20220929,广东,广东,436,89,347
结婚,20220930,广东,广东,570,95,475
结婚,20221001,广东,广东,456,72,384
结婚,20221002,广东,广东,489,99,390
结婚,20221003,广东,广东,416,78,338
结婚,20221004,广东,广东,399,87,312
结婚,20221005,广东,广东,440,87,353
结婚,20221006,广东,广东,465,110,355
结婚,20221007,广东,广东,579,76,503
结婚,20221008,广东,广东,457,83,374
结婚,20221009,广东,广东,656,70,586
结婚,20221010,广东,广东,471,74,397
结婚,20221011,广东,广东,470,82,388
结婚,20221012,广东,广东,566,91,475
结婚,20221013,广东,广东,540,108,432
结婚,20221014,广东,广东,464,95,369
结婚,20221015,广东,广东,498,93,405
结婚,20221016,广东,广东,455,82,373
结婚,20221017,广东,广东,495,101,394
结婚,20221018,广东,广东,409,97,312
结婚,20221019,广东,广东,412,82,330
结婚,20221020,广东,广东,433,89,344
结婚,20221021,广东,广东,513,91,422
结婚,20221022,广东,广东,531,80,451
结婚,20221023,广东,广东,559,102,457
结婚,20221024,广东,广东,439,99,340
结婚,20221025,广东,广东,448,101,347
结婚,20221026,广东,广东,494,118,376
结婚,20221027,广东,广东,430,85,345
结婚,20221028,广东,广东,505,82,423
结婚,20221029,广东,广东,502,80,422
结婚,20221030,广东,广东,479,91,388
结婚,20221031,广东,广东,454,82,372
结婚,20221101,广东,广东,488,97,391
结婚,20221102,广东,广东,540,87,453
结婚,20221103,广东,广东,513,95,418
结婚,20221104,广东,广东,508,95,413
结婚,20221105,广东,广东,561,64,497
结婚,20221106,广东,广东,449,76,373
结婚,20221107,广东,广东,541,95,446
结婚,20221108,广东,广东,485,99,386
结婚,20221109,广东,广东,399,76,323
结婚,20221110,广东,广东,547,87,460
结婚,20221111,广东,广东,602,83,519
结婚,20221112,广东,广东,647,80,567
结婚,20221113,广东,广东,527,95,432
结婚,20221114,广东,广东,550,93,457
结婚,20221115,广东,广东,521,85,436
结婚,20221116,广东,广东,471,102,369
结婚,20221117,广东,广东,544,93,451
结婚,20221118,广东,广东,478,87,391
结婚,20221119,广东,广东,815,85,730
结婚,20221120,广东,广东,515,85,430
结婚,20221121,广东,广东,472,99,373
结婚,20221122,广东,广东,456,87,369
结婚,20221123,广东,广东,476,78,398
结婚,20221124,广东,广东,425,87,338
结婚,20221125,广东,广东,473,80,393
结婚,20221126,广东,广东,476,74,402
结婚,20221127,广东,广东,491,97,394
结婚,20221128,广东,广东,523,87,436
结婚,20221129,广东,广东,469,97,372
结婚,20221130,广东,广东,399,85,314
结婚,20221201,广东,广东,433,93,340
结婚,20221202,广东,广东,456,80,376
结婚,20221203,广东,广东,438,72,366
结婚,20221204,广东,广东,394,82,312
结婚,20221205,广东,广东,401,89,312
结婚,20221206,广东,广东,400,95,305
结婚,20221207,广东,广东,409,83,326
结婚,20221208,广东,广东,394,95,299
结婚,20221209,广东,广东,549,89,460
结婚,20221210,广东,广东,546,82,464
结婚,20221211,广东,广东,449,91,358
结婚,20221212,广东,广东,448,95,353
结婚,20221213,广东,广东,537,101,436
结婚,20221214,广东,广东,552,91,461
结婚,20221215,广东,广东,482,76,406
结婚,20221216,广东,广东,599,85,514
结婚,20221217,广东,广东,452,78,374
结婚,20221218,广东,广东,1311,93,1218
结婚,20221219,广东,广东,1682,80,1602
结婚,20221220,广东,广东,1443,72,1371
结婚,20221221,广东,广东,1206,83,1123
结婚,20221222,广东,广东,1568,80,1488
结婚,20221223,广东,广东,1803,72,1731
结婚,20221224,广东,广东,1714,80,1634
结婚,20221225,广东,广东,1428,87,1341
结婚,20221226,广东,广东,1381,85,1296
结婚,20221227,广东,广东,1925,66,1859
结婚,20221228,广东,广东,986,76,910
结婚,20221229,广东,广东,1064,74,990
结婚,20221230,广东,广东,2020,78,1942
结婚,20221231,广东,广东,1613,61,1552
结婚,20230101,广东,广东,1790,78,1712
结婚,20230102,广东,广东,1406,80,1326
结婚,20230103,广东,广东,1082,83,999
结婚,20230104,广东,广东,1340,89,1251
结婚,20230105,广东,广东,1520,70,1450
结婚,20230106,广东,广东,1637,68,1569
结婚,20230107,广东,广东,1408,68,1340
结婚,20230108,广东,广东,1431,57,1374
结婚,20230109,广东,广东,1714,82,1632
结婚,20230110,广东,广东,1196,83,1113
结婚,20230111,广东,广东,1069,83,986
结婚,20230112,广东,广东,2005,104,1901
结婚,20230113,广东,广东,2661,72,2589
结婚,20230114,广东,广东,1612,76,1536
结婚,20230115,广东,广东,2096,112,1984
结婚,20230116,广东,广东,1640,101,1539
结婚,20230117,广东,广东,1744,121,1623
结婚,20230118,广东,广东,1590,104,1486
结婚,20230119,广东,广东,1551,89,1462
结婚,20230120,广东,广东,1994,87,1907
结婚,20230121,广东,广东,1469,66,1403
结婚,20230122,广东,广东,1557,72,1485
结婚,20230123,广东,广东,1420,85,1335
结婚,20230124,广东,广东,1333,72,1261
结婚,20230125,广东,广东,1668,70,1598
结婚,20230126,广东,广东,1341,59,1282
结婚,20230127,广东,广东,1169,61,1108
结婚,20230128,广东,广东,1030,68,962
结婚,20230129,广东,广东,1148,61,1087
结婚,20230130,广东,广东,1065,66,999
结婚,20230131,广东,广东,1190,72,1118
结婚,20230201,广东,广东,1340,70,1270
结婚,20230202,广东,广东,1104,70,1034
结婚,20230203,广东,广东,1482,97,1385
结婚,20230204,广东,广东,1791,97,1694
结婚,20230205,广东,广东,2020,129,1891
结婚,20230206,广东,广东,2506,106,2400
结婚,20230207,广东,广东,953,87,866
结婚,20230208,广东,广东,1455,112,1343
结婚,20230209,广东,广东,1491,173,1318
结婚,20230210,广东,广东,1062,114,948
结婚,20230211,广东,广东,1075,80,995
结婚,20230212,广东,广东,1020,123,897
结婚,20230213,广东,广东,525,99,426
结婚,20230214,广东,广东,2025,123,1902
结婚,20230215,广东,广东,2701,93,2608
结婚,20230216,广东,广东,2538,89,2449
结婚,20230217,广东,广东,2028,80,1948
结婚,20230218,广东,广东,2644,74,2570
结婚,20230219,广东,广东,2168,78,2090
结婚,20230220,广东,广东,2635,110,2525
结婚,20230221,广东,广东,2520,93,2427
结婚,20230222,广东,广东,2588,101,2487
结婚,20230223,广东,广东,2251,97,2154
结婚,20230224,广东,广东,3388,80,3308
结婚,20230225,广东,广东,2991,78,2913
结婚,20230226,广东,广东,2701,91,2610
结婚,20230227,广东,广东,2479,87,2392
结婚,20230228,广东,广东,3022,83,2939
结婚,20230301,广东,广东,2402,89,2313
结婚,20230302,广东,广东,3009,85,2924
结婚,20230303,广东,广东,2478,78,2400
结婚,20230304,广东,广东,2242,72,2170
结婚,20230305,广东,广东,2998,112,2886
结婚,20230306,广东,广东,1747,83,1664
结婚,20230307,广东,广东,992,85,907
结婚,20230308,广东,广东,1553,82,1471
结婚,20230309,广东,广东,560,85,475
结婚,20230310,广东,广东,1046,70,976
结婚,20230311,广东,广东,745,72,673
结婚,20230312,广东,广东,545,102,443
结婚,20230313,广东,广东,943,89,854
结婚,20230314,广东,广东,480,83,397
结婚,20230315,广东,广东,1013,76,937
结婚,20230316,广东,广东,997,78,919
结婚,20230317,广东,广东,876,82,794
结婚,20230318,广东,广东,709,64,645
结婚,20230319,广东,广东,1035,95,940
结婚,20230320,广东,广东,1300,89,1211
结婚,20230321,广东,广东,1091,91,1000
结婚,20230322,广东,广东,2746,78,2668
结婚,20230323,广东,广东,3188,76,3112
结婚,20230324,广东,广东,2579,80,2499
结婚,20230325,广东,广东,2848,85,2763
结婚,20230326,广东,广东,2714,89,2625
结婚,20230327,广东,广东,2595,85,2510
结婚,20230328,广东,广东,2241,89,2152
结婚,20230329,广东,广东,2669,78,2591
结婚,20230330,广东,广东,3499,95,3404
结婚,20230331,广东,广东,3274,78,3196
结婚,20230401,广东,广东,3187,78,3109
结婚,20230402,广东,广东,3113,83,3030
结婚,20230403,广东,广东,2365,85,2280
结婚,20230404,广东,广东,3146,85,3061
结婚,20230405,广东,广东,2948,97,2851
结婚,20230406,广东,广东,1374,80,1294
结婚,20230407,广东,广东,1190,80,1110
结婚,20230408,广东,广东,1035,68,967
结婚,20230409,广东,广东,947,91,856
结婚,20230410,广东,广东,2463,80,2383
结婚,20230411,广东,广东,2454,68,2386
结婚,20230412,广东,广东,1542,95,1447
结婚,20230413,广东,广东,1661,85,1576
结婚,20230414,广东,广东,1351,64,1287
结婚,20230415,广东,广东,1701,74,1627
结婚,20230416,广东,广东,1034,83,951
结婚,20230417,广东,广东,1507,82,1425
结婚,20230418,广东,广东,2050,83,1967
结婚,20230419,广东,广东,1074,76,998
结婚,20230420,广东,广东,1172,89,1083
结婚,20230421,广东,广东,1232,82,1150
结婚,20230422,广东,广东,1388,76,1312
结婚,20230423,广东,广东,1597,83,1514
结婚,20230424,广东,广东,1848,99,1749
结婚,20230425,广东,广东,1077,91,986
结婚,20230426,广东,广东,1785,87,1698
结婚,20230427,广东,广东,1359,78,1281
结婚,20230428,广东,广东,1504,80,1424
结婚,20230429,广东,广东,1905,78,1827
结婚,20230430,广东,广东,1312,76,1236
结婚,20230501,广东,广东,1976,91,1885
结婚,20230502,广东,广东,1007,72,935
结婚,20230503,广东,广东,1120,91,1029
结婚,20230504,广东,广东,1272,82,1190
结婚,20230505,广东,广东,1250,78,1172
结婚,20230506,广东,广东,1597,66,1531
结婚,20230507,广东,广东,1673,78,1595
结婚,20230508,广东,广东,1263,63,1200
结婚,20230509,广东,广东,1447,83,1364
结婚,20230510,广东,广东,1371,83,1288
结婚,20230511,广东,广东,1430,89,1341
结婚,20230512,广东,广东,1827,76,1751
结婚,20230513,广东,广东,1942,83,1859
结婚,20230514,广东,广东,1910,87,1823
结婚,20230515,广东,广东,1028,91,937
结婚,20230516,广东,广东,1062,74,988
结婚,20230517,广东,广东,1249,99,1150
结婚,20230518,广东,广东,1035,78,957
结婚,20230519,广东,广东,1440,80,1360
结婚,20230520,广东,广东,1854,74,1780
结婚,20230521,广东,广东,1728,87,1641
结婚,20230522,广东,广东,1605,89,1516
结婚,20230523,广东,广东,1018,91,927
结婚,20230524,广东,广东,1059,93,966
结婚,20230525,广东,广东,1011,82,929
结婚,20230526,广东,广东,2246,83,2163
结婚,20230527,广东,广东,2023,74,1949
结婚,20230528,广东,广东,935,68,867
结婚,20230529,广东,广东,1014,70,944
结婚,20230530,广东,广东,1455,89,1366
结婚,20230531,广东,广东,1308,80,1228
结婚,20230601,广东,广东,1736,80,1656
结婚,20230602,广东,广东,1297,70,1227
结婚,20230603,广东,广东,1965,83,1882
结婚,20230604,广东,广东,1825,78,1747
结婚,20230605,广东,广东,1755,78,1677
结婚,20230606,广东,广东,1166,82,1084
结婚,20230607,广东,广东,1642,85,1557
结婚,20230608,广东,广东,1598,101,1497
结婚,20230609,广东,广东,1638,76,1562
结婚,20230610,广东,广东,2314,66,2248
结婚,20230611,广东,广东,1758,82,1676
结婚,20230612,广东,广东,1455,95,1360
结婚,20230613,广东,广东,1322,76,1246
结婚,20230614,广东,广东,1346,80,1266
结婚,20230615,广东,广东,1469,78,1391
结婚,20230616,广东,广东,1599,85,1514
结婚,20230617,广东,广东,1830,82,1748
结婚,20230618,广东,广东,1790,118,1672
结婚,20230619,广东,广东,826,97,729
结婚,20230620,广东,广东,373,91,282
结婚,20230621,广东,广东,354,93,261
结婚,20230622,广东,广东,355,82,273
结婚,20230623,广东,广东,394,68,326
结婚,20230624,广东,广东,370,78,292
结婚,20230625,广东,广东,346,87,259
结婚,20230626,广东,广东,350,80,270
结婚,20230627,广东,广东,367,80,287
结婚,20230628,广东,广东,580,68,512
结婚,20230629,广东,广东,1227,70,1157
结婚,20230630,广东,广东,1047,82,965
结婚,20230701,广东,广东,988,72,916
结婚,20230702,广东,广东,1073,83,990
结婚,20230703,广东,广东,1001,82,919
结婚,20230704,广东,广东,1037,93,944
结婚,20230705,广东,广东,1464,85,1379
结婚,20230706,广东,广东,720,85,635
结婚,20230707,广东,广东,1340,74,1266
结婚,20230708,广东,广东,1024,66,958
结婚,20230709,广东,广东,1351,91,1260
结婚,20230710,广东,广东,1087,91,996
结婚,20230711,广东,广东,1140,91,1049
结婚,20230712,广东,广东,1166,83,1083
结婚,20230713,广东,广东,1704,80,1624
结婚,20230714,广东,广东,1382,70,1312
结婚,20230715,广东,广东,1426,70,1356
结婚,20230716,广东,广东,1554,83,1471
结婚,20230717,广东,广东,1811,78,1733
结婚,20230718,广东,广东,1608,85,1523
结婚,20230719,广东,广东,1305,82,1223
结婚,20230720,广东,广东,1233,93,1140
结婚,20230721,广东,广东,1553,70,1483
结婚,20230722,广东,广东,1716,78,1638
结婚,20230723,广东,广东,1458,83,1375
结婚,20230724,广东,广东,1033,78,955
结婚,20230725,广东,广东,1428,87,1341
结婚,20230726,广东,广东,1821,89,1732
结婚,20230727,广东,广东,1456,72,1384
结婚,20230728,广东,广东,1996,66,1930
结婚,20230729,广东,广东,1943,66,1877
结婚,20230730,广东,广东,1924,97,1827
结婚,20230731,广东,广东,1692,80,1612
结婚,20230801,广东,广东,2146,74,2072
结婚,20230802,广东,广东,1875,80,1795
结婚,20230803,广东,广东,1507,76,1431
结婚,20230804,广东,广东,2078,82,1996
结婚,20230805,广东,广东,2425,68,2357
结婚,20230806,广东,广东,2155,70,2085
结婚,20230807,广东,广东,1935,74,1861
结婚,20230808,广东,广东,1814,87,1727
结婚,20230809,广东,广东,1494,87,1407
结婚,20230810,广东,广东,1430,78,1352
结婚,20230811,广东,广东,1721,78,1643
结婚,20230812,广东,广东,1907,63,1844
结婚,20230813,广东,广东,1250,82,1168
结婚,20230814,广东,广东,1630,72,1558
结婚,20230815,广东,广东,1792,93,1699
结婚,20230816,广东,广东,1460,78,1382
结婚,20230817,广东,广东,1259,83,1176
结婚,20230818,广东,广东,1466,74,1392
结婚,20230819,广东,广东,1788,64,1724
结婚,20230820,广东,广东,1586,85,1501
结婚,20230821,广东,广东,1789,85,1704
结婚,20230822,广东,广东,1548,68,1480
结婚,20230823,广东,广东,1502,91,1411
结婚,20230824,广东,广东,1498,87,1411
结婚,20230825,广东,广东,1434,76,1358
结婚,20230826,广东,广东,1507,76,1431
结婚,20230827,广东,广东,1397,78,1319
结婚,20230828,广东,广东,1341,99,1242
结婚,20230829,广东,广东,1596,83,1513
结婚,20230830,广东,广东,1488,83,1405
结婚,20230831,广东,广东,1298,74,1224
结婚,20230901,广东,广东,1270,80,1190
结婚,20230902,广东,广东,1833,76,1757
结婚,20230903,广东,广东,1573,82,1491
结婚,20230904,广东,广东,2265,83,2182
结婚,20230905,广东,广东,1467,93,1374
结婚,20230906,广东,广东,1070,78,992
结婚,20230907,广东,广东,1516,74,1442
结婚,20230908,广东,广东,1735,76,1659
结婚,20230909,广东,广东,1165,76,1089
结婚,20230910,广东,广东,1506,80,1426
结婚,20230911,广东,广东,1044,89,955
结婚,20230912,广东,广东,1021,89,932
结婚,20230913,广东,广东,1122,93,1029
结婚,20230914,广东,广东,1622,72,1550
结婚,20230915,广东,广东,1458,72,1386
结婚,20230916,广东,广东,1739,72,1667
结婚,20230917,广东,广东,1253,87,1166
结婚,20230918,广东,广东,1538,78,1460
结婚,20230919,广东,广东,1262,78,1184
结婚,20230920,广东,广东,2009,85,1924
结婚,20230921,广东,广东,1446,87,1359
结婚,20230922,广东,广东,1603,83,1520
结婚,20230923,广东,广东,1503,89,1414
结婚,20230924,广东,广东,2154,104,2050
结婚,20230925,广东,广东,1821,93,1728
结婚,20230926,广东,广东,1592,91,1501
结婚,20230927,广东,广东,1370,95,1275
结婚,20230928,广东,广东,1318,91,1227
结婚,20230929,广东,广东,1053,78,975
结婚,20230930,广东,广东,1556,83,1473
结婚,20231001,广东,广东,1284,91,1193
结婚,20231002,广东,广东,1039,82,957
结婚,20231003,广东,广东,1582,87,1495
结婚,20231004,广东,广东,1205,85,1120
结婚,20231005,广东,广东,1510,68,1442
结婚,20231006,广东,广东,1395,76,1319
结婚,20231007,广东,广东,1123,72,1051
结婚,20231008,广东,广东,1316,76,1240
结婚,20231009,广东,广东,1198,72,1126
结婚,20231010,广东,广东,1089,66,1023
结婚,20231011,广东,广东,957,82,875
结婚,20231012,广东,广东,823,85,738
结婚,20231013,广东,广东,997,104,893
结婚,20231014,广东,广东,1449,87,1362
结婚,20231015,广东,广东,938,93,845
结婚,20231016,广东,广东,1710,87,1623
结婚,20231017,广东,广东,1056,85,971
结婚,20231018,广东,广东,975,97,878
结婚,20231019,广东,广东,1310,87,1223
结婚,20231020,广东,广东,1082,97,985
结婚,20231021,广东,广东,1121,78,1043
结婚,20231022,广东,广东,1173,106,1067
结婚,20231023,广东,广东,1121,87,1034
结婚,20231024,广东,广东,1217,89,1128
结婚,20231025,广东,广东,1056,82,974
结婚,20231026,广东,广东,1060,80,980
结婚,20231027,广东,广东,993,74,919
结婚,20231028,广东,广东,1068,72,996
结婚,20231029,广东,广东,779,74,705
结婚,20231030,广东,广东,947,104,843
结婚,20231031,广东,广东,988,82,906
结婚,20231101,广东,广东,1016,76,940
结婚,20231102,广东,广东,1034,85,949
结婚,20231103,广东,广东,1045,68,977
结婚,20231104,广东,广东,1061,82,979
结婚,20231105,广东,广东,1022,72,950
结婚,20231106,广东,广东,1020,91,929
结婚,20231107,广东,广东,1101,80,1021
结婚,20231108,广东,广东,736,74,662
结婚,20231109,广东,广东,1051,89,962
结婚,20231110,广东,广东,1038,72,966
结婚,20231111,广东,广东,996,68,928
结婚,20231112,广东,广东,942,89,853
结婚,20231113,广东,广东,930,76,854
结婚,20231114,广东,广东,1065,74,991
结婚,20231115,广东,广东,1046,83,963
结婚,20231116,广东,广东,967,95,872
结婚,20231117,广东,广东,1041,95,946
结婚,20231118,广东,广东,1204,76,1128
结婚,20231119,广东,广东,1206,95,1111
结婚,20231120,广东,广东,1062,82,980
结婚,20231121,广东,广东,1303,85,1218
结婚,20231122,广东,广东,1193,95,1098
结婚,20231123,广东,广东,1325,74,1251
结婚,20231124,广东,广东,1113,78,1035
结婚,20231125,广东,广东,416,70,346
结婚,20231126,广东,广东,443,106,337
结婚,20231127,广东,广东,411,104,307
结婚,20231128,广东,广东,412,112,300
结婚,20231129,广东,广东,359,91,268
结婚,20231130,广东,广东,294,63,231
结婚,20231201,广东,广东,366,74,292
结婚,20231202,广东,广东,379,72,307
结婚,20231203,广东,广东,356,97,259
结婚,20231204,广东,广东,319,83,236
结婚,20231205,广东,广东,337,83,254
结婚,20231206,广东,广东,316,89,227
结婚,20231207,广东,广东,366,99,267
结婚,20231208,广东,广东,544,91,453
结婚,20231209,广东,广东,462,78,384
结婚,20231210,广东,广东,330,91,239
结婚,20231211,广东,广东,354,87,267
结婚,20231212,广东,广东,361,87,274
结婚,20231213,广东,广东,310,85,225
结婚,20231214,广东,广东,310,74,236
结婚,20231215,广东,广东,414,68,346
结婚,20231216,广东,广东,443,82,361
结婚,20231217,广东,广东,328,104,224
结婚,20231218,广东,广东,306,91,215
结婚,20231219,广东,广东,332,83,249
结婚,20231220,广东,广东,378,89,289
离婚,20220101,广东,广东,433,64,369
离婚,20220102,广东,广东,331,74,257
离婚,20220103,广东,广东,385,87,298
离婚,20220104,广东,广东,381,89,292
离婚,20220105,广东,广东,391,82,309
离婚,20220106,广东,广东,364,68,296
离婚,20220107,广东,广东,452,72,380
离婚,20220108,广东,广东,564,95,469
离婚,20220109,广东,广东,544,89,455
离婚,20220110,广东,广东,442,91,351
离婚,20220111,广东,广东,437,83,354
离婚,20220112,广东,广东,451,104,347
离婚,20220113,广东,广东,413,85,328
离婚,20220114,广东,广东,381,76,305
离婚,20220115,广东,广东,410,72,338
离婚,20220116,广东,广东,396,80,316
离婚,20220117,广东,广东,368,74,294
离婚,20220118,广东,广东,353,78,275
离婚,20220119,广东,广东,385,87,298
离婚,20220120,广东,广东,389,76,313
离婚,20220121,广东,广东,376,76,300
离婚,20220122,广东,广东,420,76,344
离婚,20220123,广东,广东,412,99,313
离婚,20220124,广东,广东,360,78,282
离婚,20220125,广东,广东,363,76,287
离婚,20220126,广东,广东,368,70,298
离婚,20220127,广东,广东,420,87,333
离婚,20220128,广东,广东,399,76,323
离婚,20220129,广东,广东,464,80,384
离婚,20220130,广东,广东,424,93,331
离婚,20220131,广东,广东,416,82,334
离婚,20220201,广东,广东,435,76,359
离婚,20220202,广东,广东,399,66,333
离婚,20220203,广东,广东,1405,338,1067
离婚,20220204,广东,广东,658,95,563
离婚,20220205,广东,广东,461,80,381
离婚,20220206,广东,广东,377,61,316
离婚,20220207,广东,广东,412,63,349
离婚,20220208,广东,广东,376,66,310
离婚,20220209,广东,广东,457,59,398
离婚,20220210,广东,广东,406,66,340
离婚,20220211,广东,广东,484,70,414
离婚,20220212,广东,广东,474,68,406
离婚,20220213,广东,广东,483,72,411
离婚,20220214,广东,广东,488,93,395
离婚,20220215,广东,广东,525,80,445
离婚,20220216,广东,广东,458,82,376
离婚,20220217,广东,广东,463,89,374
离婚,20220218,广东,广东,528,89,439
离婚,20220219,广东,广东,542,85,457
离婚,20220220,广东,广东,600,108,492
离婚,20220221,广东,广东,584,102,482
离婚,20220222,广东,广东,528,121,407
离婚,20220223,广东,广东,446,87,359
离婚,20220224,广东,广东,478,97,381
离婚,20220225,广东,广东,563,76,487
离婚,20220226,广东,广东,512,82,430
离婚,20220227,广东,广东,446,106,340
离婚,20220228,广东,广东,405,97,308
离婚,20220301,广东,广东,414,99,315
离婚,20220302,广东,广东,394,82,312
离婚,20220303,广东,广东,362,78,284
离婚,20220304,广东,广东,424,70,354
离婚,20220305,广东,广东,462,63,399
离婚,20220306,广东,广东,387,68,319
离婚,20220307,广东,广东,387,82,305
离婚,20220308,广东,广东,402,85,317
离婚,20220309,广东,广东,429,83,346
离婚,20220310,广东,广东,379,83,296
离婚,20220311,广东,广东,449,89,360
离婚,20220312,广东,广东,528,80,448
离婚,20220313,广东,广东,455,83,372
离婚,20220314,广东,广东,427,89,338
离婚,20220315,广东,广东,464,76,388
离婚,20220316,广东,广东,392,66,326
离婚,20220317,广东,广东,378,80,298
离婚,20220318,广东,广东,426,93,333
离婚,20220319,广东,广东,453,87,366
离婚,20220320,广东,广东,438,89,349
离婚,20220321,广东,广东,460,80,380
离婚,20220322,广东,广东,433,87,346
离婚,20220323,广东,广东,419,78,341
离婚,20220324,广东,广东,457,78,379
离婚,20220325,广东,广东,485,74,411
离婚,20220326,广东,广东,551,97,454
离婚,20220327,广东,广东,574,114,460
离婚,20220328,广东,广东,468,99,369
离婚,20220329,广东,广东,424,87,337
离婚,20220330,广东,广东,431,97,334
离婚,20220331,广东,广东,411,70,341
离婚,20220401,广东,广东,487,74,413
离婚,20220402,广东,广东,444,70,374
离婚,20220403,广东,广东,410,87,323
离婚,20220404,广东,广东,434,83,351
离婚,20220405,广东,广东,401,74,327
离婚,20220406,广东,广东,452,83,369
离婚,20220407,广东,广东,432,91,341
离婚,20220408,广东,广东,417,76,341
离婚,20220409,广东,广东,410,72,338
离婚,20220410,广东,广东,453,72,381
离婚,20220411,广东,广东,457,78,379
离婚,20220412,广东,广东,456,89,367
离婚,20220413,广东,广东,431,87,344
离婚,20220414,广东,广东,379,76,303
离婚,20220415,广东,广东,416,78,338
离婚,20220416,广东,广东,403,72,331
离婚,20220417,广东,广东,413,93,320
离婚,20220418,广东,广东,406,83,323
离婚,20220419,广东,广东,464,95,369
离婚,20220420,广东,广东,389,93,296
离婚,20220421,广东,广东,377,78,299
离婚,20220422,广东,广东,431,68,363
离婚,20220423,广东,广东,479,82,397
离婚,20220424,广东,广东,436,121,315
离婚,20220425,广东,广东,398,78,320
离婚,20220426,广东,广东,398,83,315
离婚,20220427,广东,广东,404,91,313
离婚,20220428,广东,广东,367,76,291
离婚,20220429,广东,广东,434,85,349
离婚,20220430,广东,广东,471,106,365
离婚,20220501,广东,广东,417,97,320
离婚,20220502,广东,广东,432,87,345
离婚,20220503,广东,广东,448,85,363
离婚,20220504,广东,广东,429,89,340
离婚,20220505,广东,广东,430,83,347
离婚,20220506,广东,广东,399,72,327
离婚,20220507,广东,广东,406,61,345
离婚,20220508,广东,广东,424,76,348
离婚,20220509,广东,广东,392,72,320
离婚,20220510,广东,广东,438,78,360
离婚,20220511,广东,广东,390,82,308
离婚,20220512,广东,广东,394,80,314
离婚,20220513,广东,广东,425,70,355
离婚,20220514,广东,广东,423,76,347
离婚,20220515,广东,广东,445,80,365
离婚,20220516,广东,广东,411,83,328
离婚,20220517,广东,广东,393,85,308
离婚,20220518,广东,广东,452,85,367
离婚,20220519,广东,广东,375,74,301
离婚,20220520,广东,广东,376,66,310
离婚,20220521,广东,广东,447,74,373
离婚,20220522,广东,广东,352,72,280
离婚,20220523,广东,广东,397,83,314
离婚,20220524,广东,广东,369,87,282
离婚,20220525,广东,广东,410,87,323
离婚,20220526,广东,广东,362,70,292
离婚,20220527,广东,广东,455,76,379
离婚,20220528,广东,广东,447,68,379
离婚,20220529,广东,广东,388,72,316
离婚,20220530,广东,广东,389,70,319
离婚,20220531,广东,广东,412,82,330
离婚,20220601,广东,广东,362,78,284
离婚,20220602,广东,广东,366,70,296
离婚,20220603,广东,广东,398,78,320
离婚,20220604,广东,广东,431,66,365
离婚,20220605,广东,广东,402,78,324
离婚,20220606,广东,广东,390,82,308
离婚,20220607,广东,广东,415,85,330
离婚,20220608,广东,广东,359,82,277
离婚,20220609,广东,广东,419,70,349
离婚,20220610,广东,广东,454,66,388
离婚,20220611,广东,广东,489,74,415
离婚,20220612,广东,广东,513,80,433
离婚,20220613,广东,广东,424,83,341
离婚,20220614,广东,广东,547,131,416
离婚,20220615,广东,广东,469,74,395
离婚,20220616,广东,广东,484,93,391
离婚,20220617,广东,广东,452,83,369
离婚,20220618,广东,广东,466,68,398
离婚,20220619,广东,广东,409,82,327
离婚,20220620,广东,广东,423,72,351
离婚,20220621,广东,广东,387,91,296
离婚,20220622,广东,广东,423,70,353
离婚,20220623,广东,广东,424,93,331
离婚,20220624,广东,广东,488,91,397
离婚,20220625,广东,广东,446,72,374
离婚,20220626,广东,广东,431,87,344
离婚,20220627,广东,广东,426,78,348
离婚,20220628,广东,广东,396,80,316
离婚,20220629,广东,广东,422,82,340
离婚,20220630,广东,广东,392,80,312
离婚,20220701,广东,广东,417,70,347
离婚,20220702,广东,广东,476,70,406
离婚,20220703,广东,广东,422,70,352
离婚,20220704,广东,广东,393,80,313
离婚,20220705,广东,广东,379,76,303
离婚,20220706,广东,广东,425,76,349
离婚,20220707,广东,广东,367,82,285
离婚,20220708,广东,广东,423,70,353
离婚,20220709,广东,广东,435,63,372
离婚,20220710,广东,广东,498,89,409
离婚,20220711,广东,广东,475,85,390
离婚,20220712,广东,广东,433,91,342
离婚,20220713,广东,广东,427,83,344
离婚,20220714,广东,广东,433,91,342
离婚,20220715,广东,广东,427,66,361
离婚,20220716,广东,广东,435,66,369
离婚,20220717,广东,广东,464,80,384
离婚,20220718,广东,广东,400,83,317
离婚,20220719,广东,广东,369,82,287
离婚,20220720,广东,广东,430,76,354
离婚,20220721,广东,广东,417,80,337
离婚,20220722,广东,广东,395,64,331
离婚,20220723,广东,广东,445,78,367
离婚,20220724,广东,广东,442,91,351
离婚,20220725,广东,广东,406,76,330
离婚,20220726,广东,广东,402,85,317
离婚,20220727,广东,广东,409,78,331
离婚,20220728,广东,广东,396,82,314
离婚,20220729,广东,广东,431,72,359
离婚,20220730,广东,广东,435,68,367
离婚,20220731,广东,广东,470,72,398
离婚,20220801,广东,广东,407,72,335
离婚,20220802,广东,广东,390,82,308
离婚,20220803,广东,广东,418,78,340
离婚,20220804,广东,广东,430,76,354
离婚,20220805,广东,广东,408,68,340
离婚,20220806,广东,广东,457,76,381
离婚,20220807,广东,广东,430,85,345
离婚,20220808,广东,广东,408,78,330
离婚,20220809,广东,广东,407,76,331
离婚,20220810,广东,广东,398,82,316
离婚,20220811,广东,广东,380,78,302
离婚,20220812,广东,广东,371,63,308
离婚,20220813,广东,广东,409,76,333
离婚,20220814,广东,广东,1011,231,780
离婚,20220815,广东,广东,562,116,446
离婚,20220816,广东,广东,460,83,377
离婚,20220817,广东,广东,394,78,316
离婚,20220818,广东,广东,409,85,324
离婚,20220819,广东,广东,382,72,310
离婚,20220820,广东,广东,465,93,372
离婚,20220821,广东,广东,422,99,323
离婚,20220822,广东,广东,393,91,302
离婚,20220823,广东,广东,410,89,321
离婚,20220824,广东,广东,397,91,306
离婚,20220825,广东,广东,350,89,261
离婚,20220826,广东,广东,376,68,308
离婚,20220827,广东,广东,460,80,380
离婚,20220828,广东,广东,409,89,320
离婚,20220829,广东,广东,398,74,324
离婚,20220830,广东,广东,373,82,291
离婚,20220831,广东,广东,439,93,346
离婚,20220901,广东,广东,424,83,341
离婚,20220902,广东,广东,436,89,347
离婚,20220903,广东,广东,425,78,347
离婚,20220904,广东,广东,399,87,312
离婚,20220905,广东,广东,381,82,299
离婚,20220906,广东,广东,426,95,331
离婚,20220907,广东,广东,392,87,305
离婚,20220908,广东,广东,323,78,245
离婚,20220909,广东,广东,370,63,307
离婚,20220910,广东,广东,369,80,289
离婚,20220911,广东,广东,355,80,275
离婚,20220912,广东,广东,375,87,288
离婚,20220913,广东,广东,411,78,333
离婚,20220914,广东,广东,376,80,296
离婚,20220915,广东,广东,352,85,267
离婚,20220916,广东,广东,408,70,338
离婚,20220917,广东,广东,451,64,387
离婚,20220918,广东,广东,484,78,406
离婚,20220919,广东,广东,384,82,302
离婚,20220920,广东,广东,374,87,287
离婚,20220921,广东,广东,375,80,295
离婚,20220922,广东,广东,380,82,298
离婚,20220923,广东,广东,409,97,312
离婚,20220924,广东,广东,501,74,427
离婚,20220925,广东,广东,421,83,338
离婚,20220926,广东,广东,399,85,314
离婚,20220927,广东,广东,411,87,324
离婚,20220928,广东,广东,397,83,314
离婚,20220929,广东,广东,372,74,298
离婚,20220930,广东,广东,402,74,328
离婚,20221001,广东,广东,436,82,354
离婚,20221002,广东,广东,422,89,333
离婚,20221003,广东,广东,392,82,310
离婚,20221004,广东,广东,378,78,300
离婚,20221005,广东,广东,357,80,277
离婚,20221006,广东,广东,388,76,312
离婚,20221007,广东,广东,391,72,319
离婚,20221008,广东,广东,368,59,309
离婚,20221009,广东,广东,423,64,359
离婚,20221010,广东,广东,429,74,355
离婚,20221011,广东,广东,420,72,348
离婚,20221012,广东,广东,424,70,354
离婚,20221013,广东,广东,389,72,317
离婚,20221014,广东,广东,433,89,344
离婚,20221015,广东,广东,422,68,354
离婚,20221016,广东,广东,386,87,299
离婚,20221017,广东,广东,375,83,292
离婚,20221018,广东,广东,372,80,292
离婚,20221019,广东,广东,383,99,284
离婚,20221020,广东,广东,395,76,319
离婚,20221021,广东,广东,402,64,338
离婚,20221022,广东,广东,421,63,358
离婚,20221023,广东,广东,417,93,324
离婚,20221024,广东,广东,417,83,334
离婚,20221025,广东,广东,354,74,280
离婚,20221026,广东,广东,373,93,280
离婚,20221027,广东,广东,388,80,308
离婚,20221028,广东,广东,393,72,321
离婚,20221029,广东,广东,412,64,348
离婚,20221030,广东,广东,430,85,345
离婚,20221031,广东,广东,388,89,299
离婚,20221101,广东,广东,393,104,289
离婚,20221102,广东,广东,392,91,301
离婚,20221103,广东,广东,400,80,320
离婚,20221104,广东,广东,443,87,356
离婚,20221105,广东,广东,414,59,355
离婚,20221106,广东,广东,395,85,310
离婚,20221107,广东,广东,405,95,310
离婚,20221108,广东,广东,360,80,280
离婚,20221109,广东,广东,381,76,305
离婚,20221110,广东,广东,358,83,275
离婚,20221111,广东,广东,352,64,288
离婚,20221112,广东,广东,385,59,326
离婚,20221113,广东,广东,407,91,316
离婚,20221114,广东,广东,387,91,296
离婚,20221115,广东,广东,378,82,296
离婚,20221116,广东,广东,364,97,267
离婚,20221117,广东,广东,346,85,261
离婚,20221118,广东,广东,384,61,323
离婚,20221119,广东,广东,434,82,352
离婚,20221120,广东,广东,453,93,360
离婚,20221121,广东,广东,456,91,365
离婚,20221122,广东,广东,453,91,362
离婚,20221123,广东,广东,455,78,377
离婚,20221124,广东,广东,468,80,388
离婚,20221125,广东,广东,458,72,386
离婚,20221126,广东,广东,464,64,400
离婚,20221127,广东,广东,433,91,342
离婚,20221128,广东,广东,435,66,369
离婚,20221129,广东,广东,433,72,361
离婚,20221130,广东,广东,374,80,294
离婚,20221201,广东,广东,411,87,324
离婚,20221202,广东,广东,419,74,345
离婚,20221203,广东,广东,483,70,413
离婚,20221204,广东,广东,488,101,387
离婚,20221205,广东,广东,400,83,317
离婚,20221206,广东,广东,390,80,310
离婚,20221207,广东,广东,370,82,288
离婚,20221208,广东,广东,392,91,301
离婚,20221209,广东,广东,380,61,319
离婚,20221210,广东,广东,505,83,422
离婚,20221211,广东,广东,415,89,326
离婚,20221212,广东,广东,374,85,289
离婚,20221213,广东,广东,354,74,280
离婚,20221214,广东,广东,388,78,310
离婚,20221215,广东,广东,390,74,316
离婚,20221216,广东,广东,388,76,312
离婚,20221217,广东,广东,428,61,367
离婚,20221218,广东,广东,429,78,351
离婚,20221219,广东,广东,396,80,316
离婚,20221220,广东,广东,331,68,263
离婚,20221221,广东,广东,387,85,302
离婚,20221222,广东,广东,337,76,261
离婚,20221223,广东,广东,333,64,269
离婚,20221224,广东,广东,370,68,302
离婚,20221225,广东,广东,344,83,261
离婚,20221226,广东,广东,346,64,282
离婚,20221227,广东,广东,373,78,295
离婚,20221228,广东,广东,319,66,253
离婚,20221229,广东,广东,362,87,275
离婚,20221230,广东,广东,355,66,289
离婚,20221231,广东,广东,369,66,303
离婚,20230101,广东,广东,365,74,291
离婚,20230102,广东,广东,354,76,278
离婚,20230103,广东,广东,370,70,300
离婚,20230104,广东,广东,370,78,292
离婚,20230105,广东,广东,363,82,281
离婚,20230106,广东,广东,349,61,288
离婚,20230107,广东,广东,376,63,313
离婚,20230108,广东,广东,366,74,292
离婚,20230109,广东,广东,355,80,275
离婚,20230110,广东,广东,407,70,337
离婚,20230111,广东,广东,424,97,327
离婚,20230112,广东,广东,383,87,296
离婚,20230113,广东,广东,371,76,295
离婚,20230114,广东,广东,441,74,367
离婚,20230115,广东,广东,493,95,398
离婚,20230116,广东,广东,430,82,348
离婚,20230117,广东,广东,402,93,309
离婚,20230118,广东,广东,371,66,305
离婚,20230119,广东,广东,374,74,300
离婚,20230120,广东,广东,386,63,323
离婚,20230121,广东,广东,425,74,351
离婚,20230122,广东,广东,386,85,301
离婚,20230123,广东,广东,416,72,344
离婚,20230124,广东,广东,405,78,327
离婚,20230125,广东,广东,385,76,309
离婚,20230126,广东,广东,421,70,351
离婚,20230127,广东,广东,349,57,292
离婚,20230128,广东,广东,365,64,301
离婚,20230129,广东,广东,436,64,372
离婚,20230130,广东,广东,416,64,352
离婚,20230131,广东,广东,396,66,330
离婚,20230201,广东,广东,444,64,380
离婚,20230202,广东,广东,408,64,344
离婚,20230203,广东,广东,406,76,330
离婚,20230204,广东,广东,679,193,486
离婚,20230205,广东,广东,719,191,528
离婚,20230206,广东,广东,546,114,432
离婚,20230207,广东,广东,508,108,400
离婚,20230208,广东,广东,496,112,384
离婚,20230209,广东,广东,458,93,365
离婚,20230210,广东,广东,516,83,433
离婚,20230211,广东,广东,468,82,386
离婚,20230212,广东,广东,476,102,374
离婚,20230213,广东,广东,463,101,362
离婚,20230214,广东,广东,460,101,359
离婚,20230215,广东,广东,458,89,369
离婚,20230216,广东,广东,427,97,330
离婚,20230217,广东,广东,473,78,395
离婚,20230218,广东,广东,489,80,409
离婚,20230219,广东,广东,460,95,365
离婚,20230220,广东,广东,448,104,344
离婚,20230221,广东,广东,497,106,391
离婚,20230222,广东,广东,384,85,299
离婚,20230223,广东,广东,408,101,307
离婚,20230224,广东,广东,438,72,366
离婚,20230225,广东,广东,439,70,369
离婚,20230226,广东,广东,469,83,386
离婚,20230227,广东,广东,456,87,369
离婚,20230228,广东,广东,423,99,324
离婚,20230301,广东,广东,410,83,327
离婚,20230302,广东,广东,395,82,313
离婚,20230303,广东,广东,438,78,360
离婚,20230304,广东,广东,437,76,361
离婚,20230305,广东,广东,424,97,327
离婚,20230306,广东,广东,362,85,277
离婚,20230307,广东,广东,388,80,308
离婚,20230308,广东,广东,390,89,301
离婚,20230309,广东,广东,394,74,320
离婚,20230310,广东,广东,414,74,340
离婚,20230311,广东,广东,415,61,354
离婚,20230312,广东,广东,431,93,338
离婚,20230313,广东,广东,426,102,324
离婚,20230314,广东,广东,395,87,308
离婚,20230315,广东,广东,433,85,348
离婚,20230316,广东,广东,385,68,317
离婚,20230317,广东,广东,393,72,321
离婚,20230318,广东,广东,485,87,398
离婚,20230319,广东,广东,456,83,373
离婚,20230320,广东,广东,427,87,340
离婚,20230321,广东,广东,448,95,353
离婚,20230322,广东,广东,424,91,333
离婚,20230323,广东,广东,378,80,298
离婚,20230324,广东,广东,432,70,362
离婚,20230325,广东,广东,401,68,333
离婚,20230326,广东,广东,434,85,349
离婚,20230327,广东,广东,429,85,344
离婚,20230328,广东,广东,385,93,292
离婚,20230329,广东,广东,381,85,296
离婚,20230330,广东,广东,422,85,337
离婚,20230331,广东,广东,456,83,373
离婚,20230401,广东,广东,473,76,397
离婚,20230402,广东,广东,396,89,307
离婚,20230403,广东,广东,376,82,294
离婚,20230404,广东,广东,418,95,323
离婚,20230405,广东,广东,408,93,315
离婚,20230406,广东,广东,364,68,296
离婚,20230407,广东,广东,434,87,347
离婚,20230408,广东,广东,432,83,349
离婚,20230409,广东,广东,414,76,338
离婚,20230410,广东,广东,486,91,395
离婚,20230411,广东,广东,528,80,448
离婚,20230412,广东,广东,442,112,330
离婚,20230413,广东,广东,443,91,352
离婚,20230414,广东,广东,615,68,547
离婚,20230415,广东,广东,667,83,584
离婚,20230416,广东,广东,500,93,407
离婚,20230417,广东,广东,418,97,321
离婚,20230418,广东,广东,469,99,370
离婚,20230419,广东,广东,450,95,355
离婚,20230420,广东,广东,420,93,327
离婚,20230421,广东,广东,406,68,338
离婚,20230422,广东,广东,429,70,359
离婚,20230423,广东,广东,427,97,330
离婚,20230424,广东,广东,402,85,317
离婚,20230425,广东,广东,431,87,344
离婚,20230426,广东,广东,372,80,292
离婚,20230427,广东,广东,365,76,289
离婚,20230428,广东,广东,384,64,320
离婚,20230429,广东,广东,431,87,344
离婚,20230430,广东,广东,392,97,295
离婚,20230501,广东,广东,363,85,278
离婚,20230502,广东,广东,385,91,294
离婚,20230503,广东,广东,380,85,295
离婚,20230504,广东,广东,360,76,284
离婚,20230505,广东,广东,395,74,321
离婚,20230506,广东,广东,369,64,305
离婚,20230507,广东,广东,501,76,425
离婚,20230508,广东,广东,506,80,426
离婚,20230509,广东,广东,452,82,370
离婚,20230510,广东,广东,421,80,341
离婚,20230511,广东,广东,411,70,341
离婚,20230512,广东,广东,419,82,337
离婚,20230513,广东,广东,498,82,416
离婚,20230514,广东,广东,461,82,379
离婚,20230515,广东,广东,413,80,333
离婚,20230516,广东,广东,857,87,770
离婚,20230517,广东,广东,579,82,497
离婚,20230518,广东,广东,441,85,356
离婚,20230519,广东,广东,513,74,439
离婚,20230520,广东,广东,562,72,490
离婚,20230521,广东,广东,474,116,358
离婚,20230522,广东,广东,489,101,388
离婚,20230523,广东,广东,397,78,319
离婚,20230524,广东,广东,404,91,313
离婚,20230525,广东,广东,349,80,269
离婚,20230526,广东,广东,458,78,380
离婚,20230527,广东,广东,491,61,430
离婚,20230528,广东,广东,402,72,330
离婚,20230529,广东,广东,441,72,369
离婚,20230530,广东,广东,424,80,344
离婚,20230531,广东,广东,379,80,299
离婚,20230601,广东,广东,443,87,356
离婚,20230602,广东,广东,444,83,361
离婚,20230603,广东,广东,393,63,330
离婚,20230604,广东,广东,418,91,327
离婚,20230605,广东,广东,405,95,310
离婚,20230606,广东,广东,406,82,324
离婚,20230607,广东,广东,386,78,308
离婚,20230608,广东,广东,389,74,315
离婚,20230609,广东,广东,399,72,327
离婚,20230610,广东,广东,447,66,381
离婚,20230611,广东,广东,446,99,347
离婚,20230612,广东,广东,435,97,338
离婚,20230613,广东,广东,443,101,342
离婚,20230614,广东,广东,398,95,303
离婚,20230615,广东,广东,361,83,278
离婚,20230616,广东,广东,418,72,346
离婚,20230617,广东,广东,447,68,379
离婚,20230618,广东,广东,410,87,323
离婚,20230619,广东,广东,431,97,334
离婚,20230620,广东,广东,428,91,337
离婚,20230621,广东,广东,405,89,316
离婚,20230622,广东,广东,413,87,326
离婚,20230623,广东,广东,400,74,326
离婚,20230624,广东,广东,370,70,300
离婚,20230625,广东,广东,414,83,331
离婚,20230626,广东,广东,374,85,289
离婚,20230627,广东,广东,406,93,313
离婚,20230628,广东,广东,406,72,334
离婚,20230629,广东,广东,418,76,342
离婚,20230630,广东,广东,454,80,374
离婚,20230701,广东,广东,420,82,338
离婚,20230702,广东,广东,425,91,334
离婚,20230703,广东,广东,453,133,320
离婚,20230704,广东,广东,450,110,340
离婚,20230705,广东,广东,404,99,305
离婚,20230706,广东,广东,440,87,353
离婚,20230707,广东,广东,446,76,370
离婚,20230708,广东,广东,444,68,376
离婚,20230709,广东,广东,428,97,331
离婚,20230710,广东,广东,405,91,314
离婚,20230711,广东,广东,392,91,301
离婚,20230712,广东,广东,399,85,314
离婚,20230713,广东,广东,372,80,292
离婚,20230714,广东,广东,396,66,330
离婚,20230715,广东,广东,452,78,374
离婚,20230716,广东,广东,433,93,340
离婚,20230717,广东,广东,388,76,312
离婚,20230718,广东,广东,380,89,291
离婚,20230719,广东,广东,416,78,338
离婚,20230720,广东,广东,383,89,294
离婚,20230721,广东,广东,377,70,307
离婚,20230722,广东,广东,414,68,346
离婚,20230723,广东,广东,418,83,335
离婚,20230724,广东,广东,454,85,369
离婚,20230725,广东,广东,422,95,327
离婚,20230726,广东,广东,460,87,373
离婚,20230727,广东,广东,409,78,331
离婚,20230728,广东,广东,360,72,288
离婚,20230729,广东,广东,456,76,380
离婚,20230730,广东,广东,434,89,345
离婚,20230731,广东,广东,432,97,335
离婚,20230801,广东,广东,397,70,327
离婚,20230802,广东,广东,413,89,324
离婚,20230803,广东,广东,460,93,367
离婚,20230804,广东,广东,388,72,316
离婚,20230805,广东,广东,409,76,333
离婚,20230806,广东,广东,413,80,333
离婚,20230807,广东,广东,398,83,315
离婚,20230808,广东,广东,372,80,292
离婚,20230809,广东,广东,359,89,270
离婚,20230810,广东,广东,389,87,302
离婚,20230811,广东,广东,384,68,316
离婚,20230812,广东,广东,436,70,366
离婚,20230813,广东,广东,383,82,301
离婚,20230814,广东,广东,395,78,317
离婚,20230815,广东,广东,425,66,359
离婚,20230816,广东,广东,438,72,366
离婚,20230817,广东,广东,411,70,341
离婚,20230818,广东,广东,408,68,340
离婚,20230819,广东,广东,434,78,356
离婚,20230820,广东,广东,403,80,323
离婚,20230821,广东,广东,407,72,335
离婚,20230822,广东,广东,444,83,361
离婚,20230823,广东,广东,415,89,326
离婚,20230824,广东,广东,343,74,269
离婚,20230825,广东,广东,348,70,278
离婚,20230826,广东,广东,423,76,347
离婚,20230827,广东,广东,396,93,303
离婚,20230828,广东,广东,427,97,330
离婚,20230829,广东,广东,420,89,331
离婚,20230830,广东,广东,433,85,348
离婚,20230831,广东,广东,424,89,335
离婚,20230901,广东,广东,380,70,310
离婚,20230902,广东,广东,429,74,355
离婚,20230903,广东,广东,406,83,323
离婚,20230904,广东,广东,389,95,294
离婚,20230905,广东,广东,382,93,289
离婚,20230906,广东,广东,391,93,298
离婚,20230907,广东,广东,364,72,292
离婚,20230908,广东,广东,473,83,390
离婚,20230909,广东,广东,417,70,347
离婚,20230910,广东,广东,392,83,309
离婚,20230911,广东,广东,437,91,346
离婚,20230912,广东,广东,388,89,299
离婚,20230913,广东,广东,392,89,303
离婚,20230914,广东,广东,389,70,319
离婚,20230915,广东,广东,424,72,352
离婚,20230916,广东,广东,483,89,394
离婚,20230917,广东,广东,453,118,335
离婚,20230918,广东,广东,423,83,340
离婚,20230919,广东,广东,365,85,280
离婚,20230920,广东,广东,373,99,274
离婚,20230921,广东,广东,424,91,333
离婚,20230922,广东,广东,443,82,361
离婚,20230923,广东,广东,428,72,356
离婚,20230924,广东,广东,401,95,306
离婚,20230925,广东,广东,367,80,287
离婚,20230926,广东,广东,375,83,292
离婚,20230927,广东,广东,366,91,275
离婚,20230928,广东,广东,399,78,321
离婚,20230929,广东,广东,460,76,384
离婚,20230930,广东,广东,460,70,390
离婚,20231001,广东,广东,386,74,312
离婚,20231002,广东,广东,369,95,274
离婚,20231003,广东,广东,397,82,315
离婚,20231004,广东,广东,345,76,269
离婚,20231005,广东,广东,368,66,302
离婚,20231006,广东,广东,425,72,353
离婚,20231007,广东,广东,387,68,319
离婚,20231008,广东,广东,432,63,369
离婚,20231009,广东,广东,443,64,379
离婚,20231010,广东,广东,431,70,361
离婚,20231011,广东,广东,429,78,351
离婚,20231012,广东,广东,405,70,335
离婚,20231013,广东,广东,389,89,300
离婚,20231014,广东,广东,406,87,319
离婚,20231015,广东,广东,388,85,303
离婚,20231016,广东,广东,382,95,287
离婚,20231017,广东,广东,362,85,277
离婚,20231018,广东,广东,390,83,307
离婚,20231019,广东,广东,434,82,352
离婚,20231020,广东,广东,372,83,289
离婚,20231021,广东,广东,395,76,319
离婚,20231022,广东,广东,360,82,278
离婚,20231023,广东,广东,347,97,250
离婚,20231024,广东,广东,321,85,236
离婚,20231025,广东,广东,365,101,264
离婚,20231026,广东,广东,329,83,246
离婚,20231027,广东,广东,318,66,252
离婚,20231028,广东,广东,318,70,248
离婚,20231029,广东,广东,627,169,458
离婚,20231030,广东,广东,442,121,321
离婚,20231031,广东,广东,343,89,254
离婚,20231101,广东,广东,307,78,229
离婚,20231102,广东,广东,346,89,257
离婚,20231103,广东,广东,359,63,296
离婚,20231104,广东,广东,308,63,245
离婚,20231105,广东,广东,297,93,204
离婚,20231106,广东,广东,278,93,185
离婚,20231107,广东,广东,336,76,260
离婚,20231108,广东,广东,280,63,217
离婚,20231109,广东,广东,323,70,253
离婚,20231110,广东,广东,335,74,261
离婚,20231111,广东,广东,341,63,278
离婚,20231112,广东,广东,311,80,231
离婚,20231113,广东,广东,286,78,208
离婚,20231114,广东,广东,319,76,243
离婚,20231115,广东,广东,317,74,243
离婚,20231116,广东,广东,285,87,198
离婚,20231117,广东,广东,308,70,238
离婚,20231118,广东,广东,302,64,238
离婚,20231119,广东,广东,297,89,208
离婚,20231120,广东,广东,332,78,254
离婚,20231121,广东,广东,258,76,182
离婚,20231122,广东,广东,302,78,224
离婚,20231123,广东,广东,283,68,215
离婚,20231124,广东,广东,340,72,268
离婚,20231125,广东,广东,330,63,267
离婚,20231126,广东,广东,297,89,208
离婚,20231127,广东,广东,318,83,235
离婚,20231128,广东,广东,321,83,238
离婚,20231129,广东,广东,304,95,209
离婚,20231130,广东,广东,310,85,225
离婚,20231201,广东,广东,317,68,249
离婚,20231202,广东,广东,362,70,292
离婚,20231203,广东,广东,274,85,189
离婚,20231204,广东,广东,264,74,190
离婚,20231205,广东,广东,280,66,214
离婚,20231206,广东,广东,268,83,185
离婚,20231207,广东,广东,331,78,253
离婚,20231208,广东,广东,299,68,231
离婚,20231209,广东,广东,348,68,280
离婚,20231210,广东,广东,354,91,263
离婚,20231211,广东,广东,360,97,263
离婚,20231212,广东,广东,333,83,250
离婚,20231213,广东,广东,326,87,239
离婚,20231214,广东,广东,287,72,215
离婚,20231215,广东,广东,299,64,235
离婚,20231216,广东,广东,316,70,246
离婚,20231217,广东,广东,338,110,228
离婚,20231218,广东,广东,264,87,177
离婚,20231219,广东,广东,283,93,190
离婚,20231220,广东,广东,319,76,243
